width = 13
height = 12
#############
#####___#####
#_____#_#####
#_B#BBB_#####
#__oooo_#___#
###ooo#_#BB_#
###BBB__#oB_#
###__####_o_#
###|S_#__PBo#
###X|_____oB#
#######__o__#
#############