width = 11
height = 8
######___X_
#S___####|#
#_oBo#____#
#_BPB_oBo_#
#_oBo_BPB_#
#____#oBo_#
#|####____#
_X___######