width = 21
height = 7
#######_______#######
#S#___#_XXXXX_#oS__##
#_B_o_#_X|||X_##B_B_#
#_B__##_X|S|X_#_____#
#___o_#_X|||X_#__B#o#
##____#_XXXXX_#___o_#
#######_______#######