width = 9
height = 10
#########
#____####
#S##B####
####_####
####__###
##____###
#___#####
#_#####X#
#_______#
#########