width = 14
height = 14
DDDDDDDDDDDDDD
DBBBBBBBBBBBBD
DBS_DBDDBBDBBD
DBBBB_DBD_B_BD
DBD_DDB__DB_BD
DB_DBBDDBBDDBD
DBD_BDBBBDBBBD
DBDBD_D__B_DBD
DBD_BDBD_BDBBD
DBDBDBDBBB__BD
DB_DBD#BDBBDBD
DBB_BD_~_B_XBD
DBBBBBBBBBBBBD
DDDDDDDDDDDDDD