width = 19
height = 7
#######__#__#######
#_____#_#_#_#_____#
#_~_~_##___##_BbB_#
#__S__B_____|_bXb_#
#_~_~_###o###_BbB_#
#_____#_###_#_____#
#######__#__#######