width = 16
height = 8
__________######
###########o__o#
#______~~__B_B_#
#S_BB##bb##oB__#
#______~~__B_B_#
#|#########o__o#
#________X######
###########_____