width = 13
height = 9
#############
#SB_________#
##########__#
#o________B_#
##B#######|##
#~D_____b___#
#______~#BB_#
#######X#___#
#############