width = 7
height = 9
#######
#____##
#__BBb#
#_#B_b#
#_B_#b#
#__B_b#
#_#B#b#
#S__#b#
#####X#