width = 21
height = 9
~~~~~~~~~~~~~~~~~~~~~
~~~~~~~~~~~~~~~~~~~~~
~~~~~~__~~_~~~~~B~X~~
~~___~_BB~BB~~~B~~~~~
~~_S_~~~B~B~~~B~~~~~~
~~_B_~~~~~~~~B~~~~~~~
~~___~~~~___B~~~~~~~~
~~~~~~~~~~~~~~~~~~~~~
~~~~~~~~~~~~~~~~~~~~~