width = 11
height = 8
____#####__
____#___###
_####_oo_|X
##__BoBo_##
#____#___##
#_BB_#___S#
#__########
####_______