width = 13
height = 17
#############
#___#___#___#
#_B_|_S_|_o_#
#___#___#___#
######_###_##
#___#___#___#
#_~_b_B___P_#
#___#___#___#
##b#######B##
#___#___#DDD#
#_P___#_DDBD#
#___#___#DDD#
######|######
#___#D_D#___#
#_X_~_D_D_B_#
#___#D_D#___#
#############